date,doses,doses_first,doses_second,pfizer_cumul,moderna_cumul,astrazeneca_cumul,persons_first_cumul,persons_full_cumul
2020-12-27,24427,24427,0,24418,8,1,24427,0
2020-12-28,18073,18073,0,42489,9,2,42500,0
2020-12-29,50229,50229,0,92717,9,3,92729,0
2020-12-30,64213,64213,0,156929,10,3,156942,0
2020-12-31,49985,49985,0,206912,12,3,206927,0
2021-01-01,25723,25723,0,232614,27,7,232650,0
2021-01-02,47835,47835,0,280446,28,7,280485,0
2021-01-03,22614,22614,0,303053,35,7,303099,0
2021-01-04,46362,46362,0,349385,46,8,349461,0
2021-01-05,52522,52522,0,401903,50,8,401983,0
2021-01-06,63128,63128,0,465022,57,10,465111,0
2021-01-07,54921,54921,0,519931,65,13,520032,0
2021-01-08,62906,62906,0,582781,118,16,582938,0
2021-01-09,60605,60605,0,643378,126,16,643543,0
2021-01-10,35858,35858,0,679224,136,17,679401,0
2021-01-11,68803,68803,0,748014,146,20,748204,0
2021-01-12,79365,79365,0,827354,167,23,827569,0
2021-01-13,112478,112478,0,938649,1350,23,940047,0
2021-01-14,84179,84179,0,1017704,6472,25,1024226,0
2021-01-15,91942,90965,977,1104339,11758,44,1115191,977
2021-01-16,58125,56881,1244,1160768,13452,45,1172072,2221
2021-01-17,47854,30771,17083,1207355,14717,46,1202843,19304
2021-01-18,83327,67562,15765,1286416,18980,49,1270405,35069
2021-01-19,119936,83836,36100,1402532,22749,100,1354241,71169
2021-01-20,133015,79030,53985,1532699,25593,104,1433271,125154
2021-01-21,105670,64541,41129,1635538,28419,108,1497812,166283
2021-01-22,102459,68811,33648,1735786,30616,122,1566623,199931
2021-01-23,87119,40785,46334,1822539,30977,127,1607408,246265
2021-01-24,47869,25709,22160,1870199,31181,131,1633117,268425
2021-01-25,91104,52366,38738,1959845,32636,134,1685483,307163
2021-01-26,98753,51235,47518,2057148,34079,141,1736718,354681
2021-01-27,109702,51173,58529,2165046,35873,149,1787891,413210
2021-01-28,92810,47030,45780,2256217,37508,153,1834921,458990
2021-01-29,107856,49889,57967,2362514,38995,224,1884810,516957
2021-01-30,88197,34691,53506,2449821,39879,228,1919501,570463
2021-01-31,57292,25823,31469,2506722,40264,233,1945324,601932
2021-02-01,120570,58404,62166,2625011,42488,289,2003728,664098
2021-02-02,132958,65534,67424,2754802,45628,314,2069262,731522
2021-02-03,163286,64698,98588,2911658,52030,341,2133960,830110
2021-02-04,134787,62224,72563,3040535,57932,349,2196184,902673
2021-02-05,147684,69436,78248,3181732,64409,358,2265620,980921
2021-02-06,94242,45623,48619,3273333,67048,359,2311243,1029540
2021-02-07,53591,28308,25283,3324578,69390,362,2339551,1054823
2021-02-08,109523,53028,56495,3430228,73232,392,2392579,1111318
2021-02-09,134858,60317,74541,3561427,76704,579,2452896,1185859
2021-02-10,155525,77843,77682,3704233,81023,8978,2530739,1263541
2021-02-11,144835,75763,69072,3825201,88370,25496,2606502,1332613
2021-02-12,156387,80353,76034,3957776,97755,39917,2686855,1408647
2021-02-13,107939,62098,45841,4049020,101034,53332,2748953,1454488
2021-02-14,65511,39668,25843,4104742,103519,60635,2788621,1480331
2021-02-15,125995,70200,55795,4209850,108845,76184,2858821,1536126
2021-02-16,135065,78365,56700,4318955,115063,95925,2937186,1592826
2021-02-17,151995,95474,56521,4441887,123136,116911,3032660,1649347
2021-02-18,145344,91913,53431,4554902,131430,140940,3124573,1702778
2021-02-19,159021,103197,55824,4676212,141479,168601,3227770,1758602
2021-02-20,112625,76237,36388,4762981,145964,189966,3304007,1794990
2021-02-21,86100,57765,28335,4829615,149615,205778,3361772,1823325
2021-02-22,156754,98360,58394,4953266,158694,229801,3460132,1881719
2021-02-23,170680,110071,60609,5087655,166062,258722,3570203,1942328
2021-02-24,177272,117747,59525,5219922,173727,296061,3687950,2001853
2021-02-25,190515,131022,59493,5352079,180523,347623,3818972,2061346
2021-02-26,214407,146676,67731,5494183,189412,411037,3965648,2129077
2021-02-27,148463,108588,39875,5587047,193505,462540,4074236,2168952
2021-02-28,103716,79510,24206,5648752,197480,500574,4153746,2193158
2021-03-01,199544,149576,49968,5779894,207200,559256,4303322,2243126
2021-03-02,220392,168089,52303,5920957,217311,628474,4471411,2295429
2021-03-03,248823,177915,70908,6079771,232501,703292,4649326,2366337
2021-03-04,245950,182702,63248,6221694,247026,792794,4832028,2429585
2021-03-05,276258,208698,67560,6370542,260446,906782,5040726,2497145
2021-03-06,203148,154359,48789,6480187,269316,991415,5195085,2545934
2021-03-07,148075,114496,33579,6560161,276007,1052825,5309581,2579513
2021-03-08,238830,186853,51977,6694953,287002,1145867,5496434,2631490
2021-03-09,253509,198434,55075,6835774,299846,1245711,5694868,2686565
2021-03-10,289857,222324,67533,6995206,312129,1363852,5917192,2754098
2021-03-11,285153,224107,61046,7142786,325959,1487595,6141299,2815144
2021-03-12,328939,257738,71201,7294902,343373,1647003,6399037,2886345
2021-03-13,241871,191430,50441,7411311,352999,1762839,6590467,2936786
2021-03-14,170710,134969,35741,7499722,358523,1839614,6725436,2972527
2021-03-15,249771,190415,59356,7653112,371393,1923125,6915851,3031883
2021-03-16,179735,111269,68466,7820313,382718,1924334,7027120,3100349
2021-03-17,206224,124950,81274,8007648,400789,1925151,7152070,3181623
2021-03-18,194470,118533,75937,8182461,419045,1926552,7270603,3257560
2021-03-19,246409,161635,84774,8368780,439978,1965709,7432238,3342334
2021-03-20,221521,168075,53446,8504834,455339,2035815,7600313,3395780
2021-03-21,165089,126707,38382,8607401,464553,2089122,7727020,3434162
2021-03-22,270195,193364,76831,8774079,488554,2168638,7920384,3510993
2021-03-23,299489,214991,84498,8953018,508574,2269166,8135375,3595491
2021-03-24,339854,250185,89669,9151333,541997,2377279,8385560,3685160
2021-03-25,333068,251649,81419,9335910,569852,2497914,8637209,3766579
2021-03-26,374953,285789,89164,9535695,607281,2635651,8922998,3855743
2021-03-27,282663,220044,62619,9685802,635004,2740481,9143042,3918362
2021-03-28,196928,143541,53387,9801421,653575,2803216,9286583,3971749
2021-03-29,305880,216803,89077,9990379,678762,2894950,9503386,4060826
2021-03-30,326393,233812,92581,10205693,703357,2981433,9737198,4153407
2021-03-31,334480,232737,101743,10451783,739883,3033296,9969935,4255150
2021-04-01,332661,241671,90990,10692471,772547,3092585,10211606,4346159
2021-04-02,226606,158524,68082,10872526,787017,3124661,10370130,4414246
2021-04-03,232672,167885,64787,11046887,802940,3167049,10538015,4479033
2021-04-04,193658,142991,50667,11179651,813047,3217833,10681006,4529700
2021-04-05,248688,178186,70502,11345341,830957,3282921,10859192,4600202
2021-04-06,392557,297858,94699,11617529,863256,3370975,11157050,4694915
2021-04-07,725891,629464,96427,12216384,900703,3460547,11786514,4791358
2021-04-08,718490,631377,87113,12806599,936631,3552879,12417891,4878483
2021-04-09,621760,532737,89023,13285744,973535,3658583,12950628,4967511
2021-04-10,369552,304210,65342,13530159,996881,3760373,13254838,5032853
2021-04-11,261247,210772,50475,13698089,1015640,3834930,13465610,5083328
2021-04-12,412271,335423,76848,13968615,1045117,3947181,13801033,5160191
2021-04-13,603978,529940,74038,14427676,1072557,4064648,14330973,5234239
2021-04-14,808422,724505,83917,15077256,1106428,4189599,15055478,5318176
2021-04-15,682491,611748,70743,15614080,1142908,4298761,15667226,5388943
2021-04-16,582765,508119,74646,16037779,1175648,4425078,16175345,5463597
2021-04-17,359281,302581,56700,16255949,1198381,4543456,16477926,5520297
2021-04-18,267283,228162,39121,16425234,1213815,4626019,16706088,5559418
2021-04-19,398533,336463,62070,16712925,1247254,4703409,17042551,5621501
2021-04-20,589339,525717,63622,17111989,1286851,4854067,17568268,5685140
2021-04-21,749517,675277,74240,17582809,1329199,5090391,18243545,5759405
2021-04-22,639714,571629,68085,17963558,1373837,5304683,18815174,5827525
2021-04-23,541819,472045,69774,18309016,1417767,5457096,19287219,5897307
2021-04-24,362740,303487,59253,18541969,1467421,5537225,19590706,5956560
2021-04-25,280457,231107,49350,18728927,1501155,5596986,19821813,6005910
2021-04-26,436656,361920,74736,19055289,1543757,5664580,20183733,6080666
2021-04-27,859472,764836,94636,19809149,1595494,5717879,20948569,6175319
2021-04-28,1162664,1029687,132977,20859920,1656462,5767988,21978256,6308322
2021-04-29,946458,809352,137106,21685534,1720352,5824042,22787608,6445449
2021-04-30,766788,629421,137367,22329333,1777853,5888601,23417029,6582836
2021-05-01,324081,250881,73200,22569415,1819571,5928249,23667910,6656036
2021-05-02,258978,193817,65161,22759026,1857087,5958289,23861727,6721202
2021-05-03,454535,338314,116221,23074272,1927951,6025014,24200041,6837438
2021-05-04,897993,734306,163687,23744443,1991367,6186320,24934347,7001157
2021-05-05,1210824,972447,238377,24645683,2070766,6411902,25906794,7239552
2021-05-06,1001567,778041,223526,25342671,2163546,6619017,26684835,7463127
2021-05-07,857934,624388,233546,25900547,2250593,6827447,27309223,7696749
2021-05-08,413141,261353,151788,26157798,2322747,6909476,27570576,7848537
2021-05-09,280888,179709,101179,26348832,2379328,6941672,27750285,7949725
2021-05-10,603933,411692,192241,26729118,2461424,7078872,28161977,8142075
2021-05-11,1167243,868088,299155,27630297,2542241,7260289,29030065,8441276
2021-05-12,1469577,1096099,373477,28771041,2634707,7490835,30126164,8814835
2021-05-13,414424,259491,154933,29071298,2701732,7535295,30385655,8969776
2021-05-14,741438,518831,222607,29603364,2766858,7671696,30904486,9192428
2021-05-15,393980,234384,159596,29872315,2827793,7731493,31138870,9352033
2021-05-16,274209,158676,115533,30067145,2880385,7753539,31297546,9467572
2021-05-17,551980,352891,199089,30394916,2966469,7881624,31650437,9666752
2021-05-18,932169,558883,373286,31036622,3067847,8062774,32209320,10040145
2021-05-19,1190125,622058,568067,31913153,3168748,8263013,32831378,10608430
2021-05-20,985024,483496,501528,32623399,3266244,8429574,33314874,11110166
2021-05-21,843460,419107,424353,33203414,3352430,8594729,33733981,11535043
2021-05-22,397090,185897,211193,33452735,3421453,8659270,33919878,11746566
2021-05-23,272201,122844,149357,33641717,3481053,8674072,34042722,11896037
2021-05-24,316186,142034,174152,33872827,3542767,8689270,34184756,12070343
2021-05-25,686368,311952,374416,34343080,3622756,8796181,34496708,12464720
2021-05-26,1276608,595392,681216,35308340,3706022,8935177,35092100,13225336
2021-05-27,1056825,496838,559987,36055717,3795893,9068529,35588938,13861850
2021-05-28,888201,439073,449128,36642423,3882133,9197150,36028011,14386450
2021-05-29,406226,181926,224300,36894165,3944790,9259366,36209937,14629452
2021-05-30,273623,102660,170963,37084489,3991966,9286171,36312597,14803017
2021-05-31,581552,249520,332032,37465359,4059985,9366920,36562117,15180670
2021-06-01,1028181,500426,527486,38252484,4139896,9442370,37062543,15787617
2021-06-02,1318024,665976,651865,39300973,4213121,9523424,37728519,16547247
2021-06-03,641707,285743,355795,39773530,4277878,9573738,38014262,16949752
2021-06-04,800281,363719,436135,40345964,4349087,9651484,38377981,17459169
2021-06-05,412532,130427,281938,40609666,4416080,9695114,38508408,17771180
2021-06-06,272877,63321,209436,40803858,4456832,9719972,38571729,17985167
2021-06-07,610604,244991,365497,41198525,4541958,9796348,38816720,18401695
2021-06-08,1147900,442152,705588,42135171,4617506,9858874,39258872,19176379
2021-06-09,1508809,577797,930770,43392191,4704893,9923493,39836669,20198408
2021-06-10,1219609,512235,707091,44370529,4794558,9981690,40348904,20992516
2021-06-11,1037009,460145,576472,45151380,4884285,10050086,40809049,21657326
2021-06-12,433963,166951,266809,45428009,4957139,10095550,40976000,21955779
2021-06-13,262095,67650,194220,45591740,5020669,10119176,41043650,22155880
2021-06-14,641909,263892,377632,46003307,5122219,10191199,41307542,22585778
2021-06-15,1144301,445215,698816,46895720,5226721,10276432,41752757,23344008
2021-06-16,1441808,566764,874868,48054153,5332731,10375767,42319521,24291986
2021-06-17,1159500,480557,678166,48945417,5436565,10468409,42800078,25038095
2021-06-18,965366,410715,554461,49651343,5531468,10564205,43210793,25657091
2021-06-19,425413,147993,277285,49916537,5614035,10615479,43358786,25957809
2021-06-20,278943,72999,205859,50082610,5685372,10645887,43431785,26170342
2021-06-21,622271,238386,383756,50485758,5783277,10733165,43670171,26585759
2021-06-22,1162174,437567,724465,51412375,5879446,10839956,44107738,27338629
2021-06-23,1425473,562468,862880,52583959,5976040,10960327,44670206,28232553
2021-06-24,1037189,549452,487624,53377760,6063646,11074106,45219658,28755241
2021-06-25,898486,415133,483230,54052569,6140109,11180085,45634791,29269503
2021-06-26,410717,154744,255850,54302572,6209441,11254682,45789535,29537187
2021-06-27,278963,88391,190503,54463488,6267673,11310279,45877926,29730564
2021-06-28,618384,260344,357940,54853619,6357559,11425146,46138270,30107474
2021-06-29,1004789,443436,561253,55603570,6450154,11564705,46581706,30686813
2021-06-30,1128671,521541,607039,56473564,6544568,11707915,47103247,31310938
2021-07-01,955366,465928,489346,57197703,6627228,11834622,47569175,31817588
2021-07-02,826227,391169,434930,57832567,6721177,11910180,47960344,32268537
2021-07-03,379787,165737,213985,58088345,6800819,11938176,48126081,32487988
2021-07-04,255849,94318,161467,58255861,6869072,11950212,48220399,32650153
2021-07-05,529843,206707,323031,58638354,6963145,11987760,48427106,32984318
2021-07-06,845304,309213,536013,59322196,7061566,12034570,48736319,33531068
2021-07-07,1069503,360980,708355,60225348,7156429,12087412,49097299,34251279
2021-07-08,872700,290385,582217,60933873,7256695,12130875,49387684,34845783
2021-07-09,728411,225002,503241,61505327,7354497,12171329,49612686,35358466
2021-07-10,337746,105387,232277,61724853,7439614,12192861,49718073,35594456
2021-07-11,219554,67565,151893,61861843,7503556,12202833,49785638,35747307
2021-07-12,466473,161937,304434,62209330,7582435,12228024,49947575,36059466
2021-07-13,827874,210046,617740,62903753,7659139,12264979,50157621,36689344
2021-07-14,1059300,240699,818386,63817992,7730781,12313874,50398320,37521763
2021-07-15,785153,201172,583769,64470124,7801140,12353101,50599492,38119960
2021-07-16,642140,171012,471005,64997521,7865281,12381705,50770504,38602416
2021-07-17,279801,89790,186631,65179734,7928680,12397084,50860294,38790837
2021-07-18,179361,68633,110683,65296395,7970553,12407445,50928927,38901861
2021-07-19,369582,103272,266218,65584424,8021142,12425241,51032199,39174491
2021-07-20,659533,149729,509683,66160938,8069124,12446794,51181928,39690750
2021-07-21,812359,179492,632761,66890212,8114812,12470031,51361420,40330240
2021-07-22,657705,144448,513152,67470190,8158359,12489881,51505868,40850477
2021-07-23,538418,123339,414938,67934066,8200383,12505450,51629207,41270889
2021-07-24,209953,63321,146315,68085943,8238780,12512777,51692528,41418704
2021-07-25,111968,36874,75051,68157558,8270390,12515636,51729402,41493967
2021-07-26,333286,82117,251081,68427596,8309409,12528450,51811519,41748775
2021-07-27,599959,118327,481485,68950254,8351783,12550270,51929846,42234572
2021-07-28,742261,143972,598022,69606893,8398433,12574920,52073818,42837241
2021-07-29,591761,122718,468791,70120586,8441991,12594749,52196536,43310954
2021-07-30,474565,107466,366759,70518517,8487484,12609848,52304002,43681772
2021-07-31,190837,59556,131056,70655006,8523647,12615682,52363558,43813621
2021-08-01,105165,34845,70124,70727619,8548587,12617400,52398403,43883800
2021-08-02,290440,70488,219724,70964322,8582030,12626281,52468891,44106848
2021-08-03,500786,96688,403696,71401445,8620353,12638168,52565579,44515239
2021-08-04,614938,119887,494649,71953926,8657197,12650271,52685466,45014900
2021-08-05,533987,104886,428733,72425885,8697162,12657370,52790352,45449050
2021-08-06,428014,95165,332439,72796020,8732944,12664297,52885517,45785792
2021-08-07,181055,53645,126950,72930569,8765003,12665626,52939162,45913139
2021-08-08,109161,26683,82311,73013660,8786647,12666197,52965845,45995578
2021-08-09,292789,62207,230221,73249692,8828160,12671951,53028052,46228843
2021-08-10,468622,93529,374722,73655540,8870752,12680239,53121581,46607746
2021-08-11,578003,129163,448199,74160262,8918319,12689643,53250744,47060714
2021-08-12,487406,126704,360088,74582356,8956656,12696847,53377448,47426877
2021-08-13,403775,112733,290407,74919685,8997870,12702397,53490181,47721715
2021-08-14,195381,67923,126806,75065092,9030317,12703737,53558104,47848944
2021-08-15,112062,37427,74396,75148866,9051214,12704188,53595531,47923434
2021-08-16,265029,85438,178860,75363591,9084185,12707225,53680969,48106139
2021-08-17,396901,124531,271606,75708689,9113999,12712920,53805500,48382908
2021-08-18,456259,148091,307201,76109531,9144142,12718886,53953591,48695965
2021-08-19,377759,138738,237888,76435138,9170649,12724345,54092329,48940594
2021-08-20,309224,123672,184353,76695847,9194542,12728294,54216001,49129767
2021-08-21,153992,72767,80561,76813810,9215696,12728986,54288768,49210725
2021-08-22,90744,39099,51275,76882962,9231239,12729159,54327867,49262160
2021-08-23,224178,91637,131689,77060439,9260455,12732609,54419504,49397871
2021-08-24,320591,131934,187340,77334956,9286235,12736017,54551438,49591135
2021-08-25,363173,151532,209657,77650992,9311240,12739206,54702970,49806554
2021-08-26,311590,140760,168841,77919156,9333013,12741988,54843730,49982134
2021-08-27,263454,120895,140418,78138540,9355389,12744296,54964625,50127356
2021-08-28,138427,71040,66214,78246022,9370780,12744828,55035665,50194013
2021-08-29,80830,36033,43995,78312020,9379212,12744901,55071698,50238077
2021-08-30,187876,85903,100640,78467447,9396395,12746728,55157601,50342556
2021-08-31,273913,127099,144536,78707886,9412324,12748881,55284700,50492763
2021-09-01,326268,136162,166544,79000719,9428026,12750961,55420862,50664920
2021-09-02,277568,123152,135565,79247977,9441105,12752894,55544014,50807245
2021-09-03,223518,97740,109918,79443565,9453347,12754156,55641754,50921605
2021-09-04,106566,47896,53955,79531326,9461900,12754518,55689650,50975885
2021-09-05,59897,26447,30359,79580442,9467644,12754577,55716097,51006353
2021-09-06,153331,64728,72725,79713635,9477403,12755679,55780825,51082368
2021-09-07,247007,102576,118750,79938523,9486618,12756947,55883401,51206111
2021-09-08,284432,113900,138756,80196641,9498848,12758207,55997301,51349596
2021-09-09,269730,111841,129844,80439668,9510208,12759392,56109142,51485481
2021-09-10,219068,85265,111814,80629666,9522706,12760378,56194407,51601581
2021-09-11,108589,43290,59084,80718289,9531551,12760511,56237697,51660985
2021-09-12,61638,22782,34397,80769474,9536725,12760556,56260479,51695452
2021-09-13,160762,61820,78447,80907067,9546902,12761510,56322299,51777499
2021-09-14,265258,104193,123932,81149080,9555112,12763073,56426492,51906445
2021-09-15,311921,113798,148760,81433264,9566528,12764214,56540290,52060406
2021-09-16,290906,114056,136488,81696771,9576348,12765782,56654346,52203306
2021-09-17,236693,88602,117268,81906032,9587291,12766402,56742948,52324878
2021-09-18,111403,41419,62223,81999387,9594928,12766641,56784367,52387440
2021-09-19,63030,21728,36264,82051838,9600776,12766803,56806095,52423723
2021-09-20,158461,52683,80401,82191946,9608630,12767697,56858778,52507247
2021-09-21,263148,89599,125743,82435781,9616447,12768391,56948377,52637661
2021-09-22,301058,96081,143249,82713808,9626464,12769233,57044458,52785135
2021-09-23,284949,99340,135078,82976343,9634623,12769936,57143798,52925891
2021-09-24,222384,73650,113811,83176163,9644060,12770377,57217448,53043459
2021-09-25,99694,32427,57491,83260838,9650410,12770466,57249875,53101446
2021-09-26,53486,16885,31421,83306358,9654262,12770500,57266760,53132943
2021-09-27,148824,47174,73504,83440461,9660406,12770841,57313934,53209450
2021-09-28,251790,81987,117447,83676096,9666098,12771191,57395921,53331091
2021-09-29,268404,82456,125115,83928271,9671752,12771707,57478377,53460229
2021-09-30,233180,75220,113456,84145304,9677353,12772034,57553597,53577745
2021-10-01,127013,43961,57091,84262656,9680378,12772252,57597558,53638297
2021-10-02,29137,12199,13567,84286817,9682334,12772290,57609757,53652090
2021-10-03,8485,3252,3858,84293752,9683086,12772292,57613009,53656017
2021-10-04,96414,31737,43920,84381156,9686701,12772485,57644746,53702964
2021-10-05,220263,64843,101895,84590913,9690524,12772764,57709589,53808808
2021-10-06,233698,65626,104503,84813432,9694844,12772962,57775215,53917231
2021-10-07,237456,71271,110159,85038321,9699265,12773232,57846486,54032448
2021-10-08,158043,48477,69799,85185192,9703439,12773383,57894963,54105969
2021-10-09,37878,15257,17846,85217366,9705938,12773404,57910220,54124090
2021-10-10,11855,5071,5453,85227070,9706852,12773408,57915291,54129579
2021-10-11,98524,30850,42561,85317272,9710630,12773563,57946141,54174612
2021-10-12,214491,58557,93238,85520982,9715842,12773768,58004698,54271161
2021-10-13,231960,61759,97201,85741845,9721375,12774016,58066457,54371019
2021-10-14,230951,63492,100791,85961053,9726933,12774240,58129949,54475432
2021-10-15,151412,43071,65074,86101990,9732377,12774338,58173020,54542865
2021-10-16,39356,15115,18390,86136096,9734929,12774355,58188135,54561495
2021-10-17,11891,4442,5377,86144989,9737089,12774361,58192577,54566893
2021-10-18,99016,28035,40389,86236209,9741038,12774484,58220612,54609241
2021-10-19,212501,53361,88303,86439281,9746016,12774688,58273973,54699927
2021-10-20,229813,54377,89667,86659507,9751195,12774837,58328350,54791817
2021-10-21,224248,55744,89429,86874602,9755829,12774967,58384094,54883734
2021-10-22,151278,38658,58254,87016558,9760897,12775058,58422752,54943816
2021-10-23,39764,13942,15657,87050931,9763925,12775081,58436694,54959798
2021-10-24,11995,4036,4983,87061393,9764634,12775082,58440730,54964806
2021-10-25,108767,25726,40087,87163382,9768530,12775160,58466456,55006404
2021-10-26,252438,52134,91822,87405925,9774357,12775299,58518590,55100341
2021-10-27,275248,54450,91222,87670121,9781581,12775447,58573040,55193454
2021-10-28,275365,55650,92580,87934407,9788385,12775647,58628690,55288356
2021-10-29,186634,39863,58577,88110172,9795552,12775806,58668553,55348415
2021-10-30,47326,14550,15307,88151580,9799302,12775826,58683103,55363984
2021-10-31,12948,3989,4065,88162967,9800210,12775842,58687092,55368080
2021-11-01,61302,12062,16476,88219754,9803311,12775890,58699154,55385303
2021-11-02,250710,43321,73021,88460868,9810149,12776044,58742475,55459791
2021-11-03,325329,54052,80735,88773848,9818899,12776203,58796527,55542138
2021-11-04,331818,58426,84837,89093206,9827095,12776443,58854953,55629086
2021-11-05,243936,43236,53882,89323994,9836016,12776514,58898189,55684672
2021-11-06,70464,18991,16072,89385720,9841722,12776544,58917180,55701160
2021-11-07,23674,6004,5407,89406459,9843725,12776545,58923184,55706607
2021-11-08,179734,31195,36062,89575096,9851346,12776627,58954379,55744249
2021-11-09,394032,61567,79841,89953111,9862474,12776787,59015946,55826332
2021-11-10,450225,65794,79361,90386388,9874653,12776918,59081740,55907657
2021-11-11,452455,70088,81649,90820732,9887560,12777041,59151828,55992001
2021-11-12,352956,54774,53265,91156068,9900245,12777126,59206602,56047478
2021-11-13,105876,26113,17327,91252989,9906041,12777140,59232715,56065366
2021-11-14,33239,7969,4703,91283111,9908368,12777147,59240684,56070109
2021-11-15,253207,39921,35093,91522457,9918261,12777343,59280605,56107132
2021-11-16,535140,72603,73401,92038700,9932403,12777474,59353208,56183041
2021-11-17,599588,75241,71168,92616041,9949771,12777575,59428449,56256315
2021-11-18,638454,82684,77621,93229296,9968865,12777744,59511133,56337111
2021-11-19,535966,72764,54986,93737900,9988999,12778205,59583897,56394648
2021-11-20,241530,48945,20862,93957797,10003575,12778276,59632842,56416330
2021-11-21,79807,14554,6476,94026618,10012721,12778298,59647396,56423026
2021-11-22,428129,68364,35227,94422577,10037004,12778387,59715760,56461917
2021-11-23,858007,125818,75337,95227735,10077397,12778625,59841578,56543210
2021-11-24,1019861,144295,83297,96178583,10132384,12778850,59985873,56632049
2021-11-25,964492,145521,84252,97069340,10191288,12779327,60131394,56724056
2021-11-26,840547,117048,62376,97829400,10259802,12779512,60248442,56791851
2021-11-27,704974,110253,36990,98431761,10349209,12779596,60358695,56831848
2021-11-28,172259,26643,9404,98558514,10391295,12779608,60385338,56841606
2021-11-29,590629,83574,42105,99027059,10504343,12779799,60468912,56888889
2021-11-30,1049418,122892,79414,99776445,10794117,12780105,60591804,56974474
2021-12-01,1276084,125865,85545,100611107,11226472,12780346,60717669,57064874
2021-12-02,1189727,117214,89053,101372076,11645543,12780721,60834883,57159646
2021-12-03,1077928,97848,67819,102039963,12048269,12780823,60932731,57231580
2021-12-04,1018903,87582,43227,102539072,12559682,12781150,61020313,57277196
2021-12-05,273570,21368,12395,102650586,12720106,12781158,61041681,57290147
2021-12-06,752606,68226,47811,103048655,13067886,12781441,61109907,57341790
2021-12-07,1204176,94602,83620,103696809,13617116,12781588,61204509,57429973
2021-12-08,1425398,101509,90746,104430675,14302437,12781768,61306018,57524487
2021-12-09,1323759,94027,94837,105118245,14932436,12781976,61400045,57623233
2021-12-10,1224093,78818,80144,105734533,15534734,12782185,61478863,57706580
2021-12-11,1218410,73195,55986,106228173,16255146,12782228,61552058,57763976
2021-12-12,317918,17846,16795,106343227,16456836,12782239,61569904,57781065
2021-12-13,807816,54311,60014,106740430,16863588,12782335,61624215,57843473
2021-12-14,1351733,87853,111097,107484317,17467074,12782517,61712068,57957054
2021-12-15,1562042,104619,124369,108348444,18161292,12782644,61816687,58083608
2021-12-16,1463216,104728,136378,109171324,18797690,12783001,61921415,58222297
2021-12-17,1279394,105782,114134,109885741,19359471,12783128,62027197,58338222
2021-12-18,1138096,107697,77901,110443207,19937769,12783369,62134894,58416968
2021-12-19,349457,42163,22219,110609401,20120140,12783639,62177057,58439376
2021-12-20,894353,75312,89659,111097747,20523988,12783714,62252369,58530292
2021-12-21,1241591,99787,135916,111808781,21052144,12783938,62352156,58667601
2021-12-22,1219119,101057,125855,112501514,21576562,12784145,62453213,58794521
2021-12-23,671289,59508,73571,112871529,21876461,12784270,62512721,58868751
2021-12-24,48817,4010,5234,112895953,21900726,12784282,62516731,58874041
2021-12-25,27978,1648,1966,112909937,21914521,12784388,62518379,58876034
2021-12-26,62536,5304,4785,112941387,21945527,12784389,62523683,58880850
2021-12-27,605950,50794,64202,113245602,22246183,12784548,62574477,58945572
2021-12-28,748499,64692,80330,113633257,22605877,12784691,62639169,59026302
2021-12-29,700372,64948,72666,113998884,22939400,12785023,62704117,59099325
2021-12-30,486459,46796,52303,114243909,23179751,12785057,62750913,59151907
2021-12-31,59494,4775,6056,114270740,23212236,12785120,62755688,59158004
2022-01-01,28688,2217,2912,114283932,23227646,12785175,62757905,59160916
2022-01-02,154099,16418,14305,114365979,23299549,12785181,62774323,59175248
2022-01-03,481977,39593,62027,114617333,23529435,12785215,62813916,59237593
2022-01-04,701820,57530,95756,115004973,23841858,12785859,62871446,59334080
2022-01-05,817525,60426,113104,115464090,24199112,12786097,62931872,59447684
2022-01-06,684465,51570,92407,115854896,24491357,12786672,62983442,59540607
2022-01-07,767051,56808,117440,116301731,24809559,12786773,63040250,59659017
2022-01-08,520002,45721,82825,116601793,25028524,12786882,63085971,59742053
2022-01-09,185137,18712,34759,116716817,25098094,12787178,63104683,59776912
2022-01-10,560095,37381,84548,117034443,25339514,12787189,63142064,59861956
2022-01-11,797021,54386,120548,117498196,25670572,12787638,63196450,59983340
2022-01-12,881731,59833,134572,118020647,26028186,12787730,63256283,60118392
2022-01-13,837875,58329,126379,118522814,26361883,12787970,63314612,60245375
2022-01-14,780278,62559,114746,118997745,26664417,12788604,63377171,60360657
2022-01-15,467234,58750,71641,119288716,26839829,12788831,63435921,60432389
2022-01-16,154525,18921,23328,119386939,26895692,12788904,63454842,60455924
2022-01-17,481334,39585,74175,119684194,27078733,12788964,63494427,60530462
2022-01-18,652790,50699,97668,120099972,27314140,12789351,63545126,60628760
2022-01-19,681428,58592,106085,120540273,27552504,12790628,63603718,60735471
2022-01-20,701838,57829,107360,120995796,27797809,12790699,63661547,60843121
2022-01-21,598408,53448,95019,121392468,27998485,12790747,63714995,60938501
2022-01-22,296512,38357,57888,121591315,28095436,12790822,63753352,60996514
2022-01-23,107766,13282,26611,121666104,28128330,12790824,63766634,61023147
2022-01-24,357267,31091,65126,121901774,28249413,12790827,63797725,61088471
2022-01-25,500775,41553,86228,122245938,28404321,12791230,63839278,61175257
2022-01-26,504142,41515,84973,122600780,28552737,12791265,63880793,61260456
2022-01-27,510350,41832,96109,122963657,28697310,12791328,63922625,61356565
2022-01-28,438284,38566,82077,123283291,28815212,12791355,63961191,61438642
2022-01-29,211986,26526,53790,123439418,28870671,12791512,63987717,61492432
2022-01-30,75590,8919,20979,123495511,28890043,12791534,63996636,61513411
2022-01-31,232989,21557,47997,123666877,28951012,12791597,64018193,61561408
2022-02-01,293185,25569,57102,123890856,29019819,12791621,64043762,61618510
2022-02-02,361763,30642,69417,124170780,29100392,12792030,64074404,61687927
2022-02-03,342254,28737,67320,124441966,29170905,12792035,64103141,61755247
2022-02-04,312798,26159,69243,124688197,29236776,12792263,64129300,61824490
2022-02-05,147844,16374,51972,124806594,29266001,12792270,64145674,61876462
2022-02-06,53060,5584,18404,124849819,29275722,12792289,64151258,61894866
2022-02-07,167789,12841,39807,124981833,29311193,12792302,64164099,61934673
2022-02-08,276957,21560,59210,125203012,29365936,12792700,64185659,61993883
2022-02-09,283072,19984,60107,125430934,29420626,12792717,64205643,62053990
2022-02-10,277387,18793,58781,125656602,29471676,12792723,64224436,62112771
2022-02-11,251047,17523,58176,125861141,29517640,12792741,64241959,62170947
2022-02-12,110557,10512,37426,125951806,29537321,12792756,64252471,62208373
2022-02-13,34540,3027,11506,125979766,29543813,12792762,64255498,62219879
2022-02-14,134128,9550,29899,126088478,29568940,12792791,64265048,62249778
2022-02-15,224066,14420,46540,126270288,29610411,12793190,64279468,62296318
2022-02-16,224875,13059,43733,126457145,29648023,12793209,64292527,62340051
2022-02-17,228615,12837,45952,126647784,29685634,12793227,64305364,62386003
2022-02-18,210923,16222,47988,126824898,29719023,12793307,64321586,62433991
2022-02-19,81206,6714,27821,126893358,29731642,12793309,64328300,62461812
2022-02-20,31002,2386,9442,126918297,29737651,12793319,64330686,62471254
2022-02-21,132556,10289,28423,127027570,29760691,12793359,64340975,62499677
2022-02-22,203840,11705,38547,127198971,29792129,12793812,64352680,62538224
2022-02-23,207767,10780,36358,127372801,29825289,12794237,64363460,62574582
2022-02-24,210761,11400,38252,127549867,29858587,12794319,64374860,62612834
2022-02-25,176110,9525,33989,127697683,29886238,12794548,64384385,62646823
2022-02-26,61980,4987,18412,127749088,29896165,12794561,64389372,62665235
2022-02-27,19343,2359,5017,127764310,29899067,12794570,64391731,62670252
2022-02-28,103461,8807,18245,127844794,29918164,12794572,64400538,62688497
2022-03-01,162682,10119,24445,127977642,29943825,12794610,64410657,62712942
2022-03-02,161006,10956,24084,128108490,29969553,12794670,64421613,62737026
2022-03-03,216463,11381,29784,128284267,30005947,12794679,64432994,62766810
2022-03-04,163221,11374,25077,128414625,30033487,12794710,64444368,62791887
2022-03-05,55047,6417,11596,128455329,30043713,12794719,64450785,62803483
2022-03-06,22486,4300,4291,128470843,30047227,12794720,64455085,62807774
2022-03-07,95377,8000,13892,128546620,30062964,12794762,64463085,62821666
2022-03-08,169079,9205,20925,128684186,30090576,12795225,64472290,62842591
2022-03-09,178630,8203,19156,128829274,30121020,12795342,64480493,62861747
2022-03-10,194978,8571,20918,128987525,30155470,12795355,64489064,62882665
2022-03-11,167800,9510,20566,129122248,30185196,12795866,64498574,62903231
2022-03-12,52276,4502,8990,129162042,30195569,12795872,64503076,62912221
2022-03-13,18528,1648,2936,129175557,30200171,12795872,64504724,62915157
2022-03-14,92513,4919,9322,129249665,30217345,12795878,64509643,62924479
2022-03-15,174369,7279,15994,129391787,30247623,12796253,64516922,62940473
2022-03-16,183536,6547,13902,129539860,30281493,12796261,64523469,62954375
2022-03-17,194517,6425,14644,129697351,30317239,12796289,64529894,62969019
2022-03-18,149583,6458,13401,129818818,30343822,12796305,64536352,62982420
2022-03-19,48072,3465,6473,129855722,30353459,12796310,64539817,62988893
2022-03-20,17070,1803,3102,129868741,30356747,12796310,64541620,62991995
2022-03-21,94848,4015,8784,129944302,30373701,12796319,64545635,63000779
2022-03-22,168023,7015,14082,130080116,30402297,12796699,64552650,63014861
2022-03-23,179042,5849,13433,130224842,30432737,12796706,64558499,63028294
2022-03-24,183998,6035,13502,130374425,30463805,12796708,64564534,63041796
2022-03-25,152419,5346,13361,130496891,30489431,12796745,64569880,63055157
2022-03-26,42923,2845,6875,130528293,30497896,12796776,64572725,63062032
2022-03-27,16174,929,2749,130539782,30501129,12796776,64573654,63064781
2022-03-28,93861,3354,8467,130612965,30518405,12796877,64577008,63073248
2022-03-29,166071,5614,11402,130747894,30546154,12797278,64582622,63084650
2022-03-30,187071,5095,11007,130899132,30579150,12797341,64587717,63095657
2022-03-31,181697,5832,12564,131045870,30611651,12797386,64593549,63108221
2022-04-01,120052,4021,9168,131143455,30631919,12797386,64597570,63117389
2022-04-02,34970,2039,4160,131169734,30638884,12797417,64599609,63121549
2022-04-03,13832,965,1511,131180436,30641585,12797417,64600574,63123060
2022-04-04,75098,2268,4963,131240713,30655201,12797419,64602842,63128023
2022-04-05,152489,4210,8627,131367954,30678677,12797800,64607052,63136650
2022-04-06,183140,5645,12058,131518630,30709497,12797800,64612697,63148708
2022-04-07,183231,3899,8943,131671988,30738017,12797800,64616596,63157651
2022-04-08,142306,3633,8377,131789494,30760647,12797840,64620229,63166028
2022-04-09,33493,1568,3850,131814224,30768158,12797840,64621797,63169878
2022-04-10,11217,549,1240,131823317,30769992,12797840,64622346,63171118
2022-04-11,64029,1936,4296,131875684,30780661,12797888,64624282,63175414
2022-04-12,119432,2550,5646,131976569,30798100,12797921,64626832,63181060
2022-04-13,126762,4377,5594,132083331,30816800,12797941,64631209,63186654
2022-04-14,105615,2732,6026,132171697,30832734,12798057,64633941,63192680
2022-04-15,6346,311,627,132176629,30833996,12798057,64634252,63193307
2022-04-16,7160,486,1090,132182085,30835327,12798057,64634738,63194397
2022-04-17,1960,223,285,132183500,30835809,12798057,64634961,63194682
2022-04-18,2805,173,361,132185539,30836481,12798057,64635134,63195043
2022-04-19,75220,4508,4793,132248746,30847353,12798067,64639642,63199836
2022-04-20,92406,2116,4959,132326553,30860829,12798084,64641758,63204795
2022-04-21,104254,2131,5594,132414866,30875784,12798086,64643889,63210389
2022-04-22,85250,2423,6206,132485040,30889696,12798098,64646312,63216595
2022-04-23,20432,1163,2875,132499996,30894388,12798114,64647475,63219470
2022-04-24,6568,377,797,132505059,30895682,12798117,64647852,63220267
2022-04-25,54061,1944,4184,132550844,30903244,12798121,64649796,63224451
2022-04-26,116973,4999,8451,132649377,30919404,12798742,64654795,63232902
2022-04-27,119834,2562,6044,132752015,30935611,12798747,64657357,63238946
2022-04-28,122555,2551,6250,132856817,30952469,12798749,64659908,63245196
2022-04-29,103409,7563,10410,132944681,30965744,12799995,64667471,63255606
2022-04-30,21238,1172,2824,132961046,30969894,12800001,64668643,63258430
2022-05-01,4396,258,348,132964506,30970718,12800001,64668901,63258778
2022-05-02,42981,1377,2648,133000527,30977180,12800023,64670278,63261426
2022-05-03,91735,2955,5996,133079645,30988657,12800396,64673233,63267422
2022-05-04,148174,2568,5842,133206180,31009575,12800401,64675801,63273264
2022-05-05,105699,3089,6037,133297992,31022358,12800697,64678890,63279301
2022-05-06,76803,1967,4106,133364822,31031592,12800704,64680857,63283407
2022-05-07,15354,844,1766,133377090,31034383,12800707,64681701,63285173
2022-05-08,4354,204,454,133380870,31034916,12800707,64681905,63285627
2022-05-09,35853,1041,2113,133411266,31040053,12800707,64682946,63287740
2022-05-10,82711,2371,4381,133483050,31050011,12801082,64685317,63292121
2022-05-11,83477,1792,3459,133556433,31059532,12801083,64687109,63295580
2022-05-12,86290,1895,3752,133632380,31069236,12801083,64689004,63299332
2022-05-13,59717,1463,3315,133684085,31076815,12801086,64690467,63302647
2022-05-14,11690,656,1423,133693469,31078804,12801086,64691123,63304070
2022-05-15,4151,263,524,133696691,31079621,12801086,64691386,63304594
2022-05-16,31041,966,1982,133723414,31083605,12801106,64692352,63306576
2022-05-17,69657,2275,4147,133784343,31091391,12801488,64694627,63310723
2022-05-18,68528,1350,3167,133845456,31098380,12801489,64695977,63313890
2022-05-19,75016,1708,3781,133911655,31106776,12801489,64697685,63317671
2022-05-20,55408,1393,3131,133959450,31113888,12801497,64699078,63320802
2022-05-21,11771,702,1524,133968988,31115719,12801511,64699780,63322326
2022-05-22,3588,171,394,133972023,31116190,12801512,64699951,63322720
2022-05-23,28973,898,1969,133996962,31119895,12801513,64700849,63324689
2022-05-24,63265,2372,4294,134052591,31126589,12801900,64703221,63328983
2022-05-25,61158,1863,3403,134106569,31133286,12801901,64705084,63332386
2022-05-26,2496,181,228,134108543,31133713,12801901,64705265,63332614
2022-05-27,20955,952,1857,134126149,31136685,12801901,64706217,63334471
2022-05-28,7790,648,1011,134132353,31138018,12801901,64706865,63335482
2022-05-29,2623,230,344,134134428,31138457,12801901,64707095,63335826
2022-05-30,25082,885,1805,134156193,31141455,12801901,64707980,63337631
2022-05-31,48858,1521,3002,134199152,31146880,12801906,64709501,63340633
2022-06-01,49877,1310,2618,134243724,31151822,12801912,64710811,63343251
2022-06-02,56924,1472,3319,134294285,31157813,12801918,64712283,63346570
2022-06-03,42997,1535,2781,134332014,31162658,12801924,64713818,63349351
2022-06-04,7780,514,822,134338320,31163929,12801926,64714332,63350173
2022-06-05,1617,57,142,134339734,31164102,12801926,64714389,63350315
2022-06-06,1811,60,142,134341316,31164313,12801926,64714449,63350457
2022-06-07,33587,1161,2270,134370594,31168071,12802130,64715610,63352727
2022-06-08,42642,1231,2256,134407792,31173170,12802130,64716841,63354983
2022-06-09,52051,1536,2978,134454117,31178457,12802130,64718377,63357961
2022-06-10,37928,1326,2556,134486832,31183294,12802133,64719703,63360517
2022-06-11,9681,749,1003,134494486,31185076,12802133,64720452,63361520
2022-06-12,2376,208,319,134496346,31185531,12802133,64720660,63361839
2022-06-13,23219,852,1596,134516523,31188300,12802135,64721512,63363435
2022-06-14,45877,1344,2521,134557073,31193234,12802137,64722856,63365956
2022-06-15,48249,1907,2563,134598938,31199230,12802137,64724763,63368519
2022-06-16,27195,997,1863,134621493,31203714,12802137,64725760,63370382
2022-06-17,33711,1108,1966,134648597,31209972,12802137,64726868,63372348
2022-06-18,9851,599,792,134656050,31212171,12802137,64727467,63373140
2022-06-19,4449,342,448,134659375,31213114,12802171,64727809,63373588
2022-06-20,25749,930,1374,134681152,31216839,12802173,64728739,63374962
2022-06-21,49873,1328,2418,134724760,31222696,12802174,64730067,63377380
2022-06-22,55004,1311,2253,134771773,31230236,12802175,64731378,63379633
2022-06-23,64519,1515,2564,134828160,31238052,12802181,64732893,63382197
2022-06-24,48742,1731,2665,134869297,31245218,12802181,64734624,63384862
2022-06-25,12272,719,979,134878808,31247751,12802182,64735343,63385841
2022-06-26,3279,254,369,134881478,31248269,12802182,64735597,63386210
2022-06-27,24571,822,1253,134902460,31251645,12802183,64736419,63387463
2022-06-28,55852,2419,2992,134952045,31257238,12802210,64738838,63390455
2022-06-29,54614,1431,2202,134999768,31263774,12802223,64740269,63392657
2022-06-30,61444,1606,2882,135054551,31270103,12802225,64741875,63395539
2022-07-01,35815,1329,1939,135085200,31274924,12802225,64743204,63397478
2022-07-02,10493,515,896,135093591,31276884,12802243,64743719,63398374
2022-07-03,2711,104,205,135095837,31277307,12802243,64743823,63398579
2022-07-04,21106,621,981,135113955,31280177,12802247,64744444,63399560
2022-07-05,47734,1161,1793,135156362,31285274,12802248,64745605,63401353
2022-07-06,52635,1300,2031,135202628,31291356,12802249,64746905,63403384
2022-07-07,60521,1555,2950,135255988,31298149,12802262,64748460,63406334
2022-07-08,42611,1339,1964,135292497,31303895,12802262,64749799,63408298
2022-07-09,11614,604,780,135301572,31306272,12802262,64750403,63409078
2022-07-10,2799,83,158,135303829,31306756,12802265,64750486,63409236
2022-07-11,25231,982,1602,135325022,31310181,12802273,64751468,63410838
2022-07-12,57508,1475,2234,135375367,31316999,12802273,64752943,63413072
2022-07-13,60065,1184,1959,135427214,31325010,12802276,64754127,63415031
2022-07-14,65813,1166,1906,135484305,31333515,12802278,64755293,63416937
2022-07-15,54889,1401,2152,135528945,31343441,12802279,64756694,63419089
2022-07-16,16472,672,799,135541259,31347392,12802294,64757366,63419888
2022-07-17,3907,158,215,135544309,31348176,12802294,64757524,63420103
2022-07-18,26268,679,936,135566251,31352322,12802318,64758203,63421039
2022-07-19,52269,1021,1593,135612427,31358161,12802318,64759224,63422632
2022-07-20,50914,976,1501,135657196,31364099,12802318,64760200,63424133
2022-07-21,64066,1255,1787,135713084,31371963,12802318,64761455,63425920
2022-07-22,49138,2048,2164,135754610,31378831,12802318,64763503,63428084
2022-07-23,11137,552,681,135763141,31381250,12802318,64764055,63428765
2022-07-24,4257,372,515,135766701,31381854,12802318,64764427,63429280
2022-07-25,22305,576,895,135786085,31384643,12802328,64765003,63430175
2022-07-26,51438,1129,1682,135831713,31390187,12802329,64766132,63431857
2022-07-27,53058,1059,1557,135878543,31396153,12802330,64767191,63433414
2022-07-28,55346,973,1565,135927963,31401822,12802330,64768164,63434979
2022-07-29,41949,1330,1477,135964402,31406852,12802342,64769494,63436456
2022-07-30,9625,476,708,135971931,31408790,12802342,64769970,63437164
2022-07-31,2838,124,146,135974054,31409402,12802343,64770094,63437310
2022-08-01,19544,817,992,135990513,31412210,12802465,64770911,63438302
2022-08-02,38336,781,1184,136024481,31416343,12802465,64771692,63439486
2022-08-03,41756,909,1479,136061632,31420723,12802475,64772601,63440965
2022-08-04,42740,882,1294,136100267,31424594,12802475,64773483,63442259
2022-08-05,32734,948,1293,136128604,31428751,12802476,64774431,63443552
2022-08-06,9283,458,643,136135774,31430688,12802476,64774889,63444195
2022-08-07,2106,102,136,136137548,31430971,12802476,64774991,63444331
2022-08-08,17285,534,714,136152398,31433219,12802478,64775525,63445045
2022-08-09,38140,813,1290,136186376,31437221,12802478,64776338,63446335
2022-08-10,39391,866,1424,136221697,31441118,12802478,64777204,63447759
2022-08-11,40806,883,1421,136258302,31445106,12802478,64778087,63449180
2022-08-12,28888,881,1221,136283693,31448370,12802478,64778968,63450401
2022-08-13,6000,370,497,136288283,31449592,12802483,64779338,63450898
2022-08-14,1968,115,145,136289920,31449810,12802483,64779453,63451043
2022-08-15,13625,490,689,136301525,31451643,12802491,64779943,63451732
2022-08-16,32627,822,1294,136330837,31454733,12802492,64780765,63453026
2022-08-17,35461,1090,1485,136363059,31457707,12802497,64781855,63454511
2022-08-18,42463,3865,3627,136401740,31461093,12802578,64785720,63458138
2022-08-19,29447,960,1415,136426938,31465062,12802579,64786680,63459553
2022-08-20,7144,301,506,136432608,31466398,12802582,64786981,63460059
2022-08-21,2319,97,162,136434425,31466831,12802582,64787078,63460221
2022-08-22,16958,572,789,136448733,31469312,12802585,64787650,63461010
2022-08-23,34952,849,1248,136479897,31472934,12802585,64788499,63462258
2022-08-24,38367,924,1317,136514257,31476682,12802585,64789423,63463575
2022-08-25,38151,763,1242,136548326,31480523,12802586,64790186,63464817
2022-08-26,29205,816,1339,136573620,31484159,12802587,64791002,63466156
2022-08-27,6987,347,474,136578747,31485844,12802587,64791349,63466630
2022-08-28,1820,101,106,136580174,31486199,12802587,64791450,63466736
2022-08-29,16870,557,768,136594778,31488251,12802595,64792007,63467504
2022-08-30,33334,779,1224,136624841,31491320,12802596,64792786,63468728
2022-08-31,36403,947,1345,136657621,31494699,12802596,64793733,63470073
2022-09-01,32218,786,1093,136687064,31497248,12802596,64794519,63471166
2022-09-02,27509,969,1226,136711499,31500104,12802597,64795488,63472392
2022-09-03,6049,370,568,136716479,31501005,12802597,64795858,63472960
2022-09-04,1796,82,102,136718062,31501182,12802597,64795940,63473062
2022-09-05,13996,619,700,136730385,31502705,12802598,64796559,63473762
2022-09-06,28085,856,1202,136756078,31504891,12802598,64797415,63474964
2022-09-07,29400,783,1151,136782590,31507338,12802598,64798198,63476115
2022-09-08,29809,852,1198,136809057,31509768,12802600,64799050,63477313
2022-09-09,21768,882,1120,136827428,31511985,12802600,64799932,63478433
2022-09-10,6892,375,513,136832653,31512956,12802600,64800307,63478946
2022-09-11,1778,105,158,136833999,31513229,12802600,64800412,63479104
2022-09-12,15221,539,690,136846792,31514444,12802603,64800951,63479794
2022-09-13,44606,846,1239,136885004,31518063,12802603,64801797,63481033
2022-09-14,51655,891,1263,136927612,31522464,12802603,64802688,63482296
2022-09-15,55486,875,1334,136974529,31527154,12802608,64803563,63483630
2022-09-16,44693,799,1179,137009590,31531762,12802631,64804362,63484809
2022-09-17,12556,312,472,137017866,31533749,12802631,64804674,63485281
2022-09-18,3396,96,165,137020425,31534268,12802634,64804770,63485446
2022-09-19,23638,591,681,137039521,31536317,12802646,64805361,63486127
2022-09-20,53266,689,1130,137084221,31539974,12802646,64806050,63487257
2022-09-21,59121,834,1054,137132174,31543471,12802646,64806884,63488311
2022-09-22,65503,843,1303,137187213,31547005,12802656,64807727,63489614
2022-09-23,51106,711,1130,137226389,31550277,12802656,64808438,63490744
2022-09-24,14122,364,590,137234664,31551359,12802656,64808802,63491334
2022-09-25,5163,152,183,137238583,31551911,12802700,64808954,63491517
2022-09-26,32064,698,729,137263275,31553452,12802711,64809652,63492246
2022-09-27,77028,859,1209,137327584,31556400,12802711,64810511,63493455
2022-09-28,87167,1133,1629,137398144,31558670,12802711,64811644,63495084
2022-09-29,101426,981,1843,137481309,31561622,12802711,64812625,63496927
2022-09-30,86699,935,1554,137543960,31564620,12802712,64813560,63498481
2022-10-01,27642,367,622,137559164,31565227,12802712,64813927,63499103
2022-10-02,6689,173,370,137563516,31565427,12802712,64814100,63499473
2022-10-03,9166,282,373,137569899,31566104,12802712,64814382,63499846
2022-10-04,70623,833,1173,137585773,31566874,12802737,64815215,63501019
2022-10-05,102137,1130,1260,137607723,31567929,12802737,64816345,63502279
2022-10-06,120899,1218,1303,137628106,31568572,12802737,64817563,63503582
2022-10-07,106268,1313,1408,137645541,31569563,12802737,64818876,63504990
2022-10-08,31498,426,531,137652079,31570007,12802737,64819302,63505521
2022-10-09,8868,263,256,137654429,31570149,12802737,64819565,63505777
2022-10-10,59119,656,797,137662844,31570514,12802737,64820221,63506574
2022-10-11,115112,952,1011,137675557,31570895,12802738,64821173,63507585
2022-10-12,124828,1137,1109,137689110,31571227,12802738,64822310,63508694
2022-10-13,145542,1153,1251,137703982,31571754,12802738,64823463,63509945
2022-10-14,127042,1700,1088,137717430,31572168,12802883,64825163,63511033
2022-10-15,41199,493,565,137723563,31572652,12802883,64825656,63511598
2022-10-16,11529,167,197,137725225,31572779,12802883,64825823,63511795
2022-10-17,70521,585,641,137733723,31572971,12802909,64826408,63512436
2022-10-18,133726,857,1022,137746098,31573268,12802909,64827265,63513458
2022-10-19,145051,1147,1188,137761192,31573473,12802911,64828412,63514646
2022-10-20,145882,1032,1037,137768320,31573698,12802960,64829444,63515683
2022-10-21,135213,1271,1071,137781210,31573988,12802961,64830715,63516754
2022-10-22,39380,373,374,137786124,31574073,12802961,64831088,63517128
2022-10-23,9490,57,87,137787019,31574128,12802961,64831145,63517215
2022-10-24,88233,849,584,137800184,31574300,12802973,64831994,63517799
2022-10-25,132340,845,928,137815196,31574454,12802974,64832839,63518727
2022-10-26,114138,977,814,137821491,31574695,12802974,64833816,63519541
2022-10-27,160739,950,1152,137840295,31574934,12802974,64834766,63520693
2022-10-28,120997,1427,983,137852141,31575198,12802974,64836193,63521676
2022-10-29,30025,372,346,137855809,31575355,12802974,64836565,63522022
2022-10-30,7058,38,70,137856809,31575371,12802974,64836603,63522092
2022-10-31,37109,347,358,137860918,31575539,12802989,64836950,63522450
2022-11-01,53317,481,516,137866165,31575572,12802989,64837431,63522966
2022-11-02,110268,817,900,137878545,31575681,12802989,64838248,63523866
2022-11-03,144566,1112,1215,137893368,31575948,12802992,64839360,63525081
2022-11-04,108494,862,939,137903615,31576122,12802993,64840222,63526020
2022-11-05,25397,328,406,137906624,31576278,12802993,64840550,63526426
2022-11-06,7585,111,111,137907384,31576333,12802993,64840661,63526537
2022-11-07,58939,509,463,137912047,31576372,12802994,64841170,63527000
2022-11-08,134915,1268,987,137927595,31576600,12802994,64842438,63527987
2022-11-09,132907,971,801,137939616,31576750,12802994,64843409,63528788
2022-11-10,143972,1206,948,137951871,31576912,12802994,64844615,63529736
2022-11-11,111346,753,878,137961155,31577080,12802994,64845368,63530614
2022-11-12,24090,242,273,137963449,31577202,12802994,64845610,63530887
2022-11-13,7686,75,90,137964206,31577224,12802994,64845685,63530977
2022-11-14,56399,533,463,137969215,31577373,12803000,64846218,63531440
2022-11-15,109609,774,696,137978471,31577530,12803000,64846992,63532136
2022-11-16,111528,901,694,137988908,31577688,12803000,64847893,63532830
2022-11-17,127188,679,695,137999211,31577801,12803000,64848572,63533525
2022-11-18,93995,749,767,138006526,31577968,12803000,64849321,63534292
2022-11-19,22462,431,265,138008984,31578060,12803000,64849752,63534557
2022-11-20,6387,48,66,138009698,31578137,12803000,64849800,63534623
2022-11-21,48590,408,496,138013591,31578181,12803011,64850208,63535119
2022-11-22,94505,620,635,138021727,31578340,12803011,64850828,63535754
2022-11-23,97002,736,622,138030015,31578417,12803011,64851564,63536376
2022-11-24,108773,728,700,138038863,31578556,12803011,64852292,63537076
2022-11-25,76318,550,647,138044656,31578653,12803014,64852842,63537723
2022-11-26,16321,342,250,138046995,31578817,12803014,64853184,63537973
2022-11-27,5775,97,109,138047459,31578873,12803014,64853281,63538082
2022-11-28,36712,347,287,138050643,31578985,12803015,64853628,63538369
2022-11-29,76709,536,529,138056602,31579229,12803015,64854164,63538898
2022-11-30,79589,588,691,138063281,31579567,12803015,64854752,63539589
2022-12-01,85746,605,596,138070021,31579723,12803015,64855357,63540185
2022-12-02,60706,665,564,138074787,31579931,12803016,64856022,63540749
2022-12-03,13787,268,512,138076427,31580036,12803016,64856290,63541261
2022-12-04,3449,20,39,138077046,31580090,12803016,64856310,63541300
2022-12-05,32253,221,285,138079682,31580171,12803016,64856531,63541585
2022-12-06,62796,405,358,138084864,31580388,12803018,64856936,63541943
2022-12-07,71696,452,589,138090666,31580510,12803018,64857388,63542532
2022-12-08,73668,532,552,138097137,31580683,12803018,64857920,63543084
2022-12-09,52730,511,522,138101944,31580838,12803032,64858431,63543606
2022-12-10,11420,152,232,138103078,31580896,12803032,64858583,63543838
2022-12-11,4666,93,160,138103634,31581032,12803032,64858676,63543998
2022-12-12,27040,343,312,138106357,31581090,12803032,64859019,63544310
2022-12-13,55110,391,457,138110655,31581295,12803032,64859410,63544767
2022-12-14,57779,492,620,138115791,31581375,12803038,64859902,63545387
2022-12-15,63741,549,470,138121146,31581506,12803038,64860451,63545857
2022-12-16,45861,296,439,138125240,31581626,12803038,64860747,63546296
2022-12-17,9890,150,169,138126219,31581697,12803038,64860897,63546465
2022-12-18,2798,27,36,138126515,31581765,12803038,64860924,63546501
2022-12-19,22670,288,332,138128722,31581888,12803041,64861212,63546833
2022-12-20,35194,257,371,138131660,31581905,12803041,64861469,63547204
2022-12-21,34749,459,545,138134911,31582193,12803041,64861928,63547749
2022-12-22,30518,404,501,138138030,31582307,12803041,64862332,63548250
2022-12-23,18398,181,259,138139465,31582349,12803041,64862513,63548509
2022-12-24,1285,44,76,138139590,31582417,12803041,64862557,63548585
2022-12-25,1477,2,2,138139599,31582463,12803041,64862559,63548587
2022-12-26,1016,25,27,138139687,31582463,12803041,64862584,63548614
2022-12-27,11620,207,318,138141027,31582582,12803041,64862791,63548932
2022-12-28,13383,237,351,138142433,31582772,12803041,64863028,63549283
2022-12-29,13812,293,282,138144534,31582813,12803041,64863321,63549565
2022-12-30,15989,264,402,138147026,31583023,12803047,64863585,63549967
2022-12-31,6277,53,69,138147558,31583069,12803047,64863638,63550036
2023-01-01,366,5,3,138147597,31583069,12803047,64863643,63550039
2023-01-02,4147,103,154,138148178,31583112,12803047,64863746,63550193
2023-01-03,9374,91,108,138148990,31583121,12803047,64863837,63550301
2023-01-04,13738,159,243,138150315,31583133,12803047,64863996,63550544
2023-01-05,18624,256,274,138152231,31583201,12803047,64864252,63550818
2023-01-06,13014,105,167,138153450,31583234,12803047,64864357,63550985
2023-01-07,3974,181,143,138153851,31583287,12803047,64864538,63551128
2023-01-08,2006,12,12,138153994,31583287,12803047,64864550,63551140
2023-01-09,9463,128,140,138154923,31583329,12803047,64864678,63551280
2023-01-10,24623,265,360,138157059,31583360,12803047,64864943,63551640
2023-01-11,26902,271,320,138158273,31583518,12803047,64865214,63551960
2023-01-12,32900,395,446,138161489,31583616,12803047,64865609,63552406
2023-01-13,24056,373,357,138163188,31583830,12803048,64865982,63552763
2023-01-14,4005,80,79,138163628,31583862,12803048,64866062,63552842
2023-01-15,1845,27,33,138163939,31583953,12803048,64866089,63552875
2023-01-16,9856,134,155,138164815,31583993,12803048,64866223,63553030
2023-01-17,21337,313,258,138166402,31584030,12803048,64866536,63553288
2023-01-18,21474,710,322,138168078,31584096,12803048,64867246,63553610
2023-01-19,23946,325,393,138169914,31584136,12803048,64867571,63554003
2023-01-20,16749,361,282,138171046,31584238,12803048,64867932,63554285
2023-01-21,2997,57,62,138171156,31584240,12803048,64867989,63554347
2023-01-22,1073,22,14,138171194,31584241,12803048,64868011,63554361
2023-01-23,8061,99,155,138171775,31584316,12803048,64868110,63554516
2023-01-24,16601,423,238,138173058,31584350,12803048,64868533,63554754
2023-01-25,17304,222,290,138174414,31584452,12803048,64868755,63555044
2023-01-26,18496,228,216,138175594,31584494,12803048,64868983,63555260
2023-01-27,12438,186,151,138176598,31584572,12803048,64869169,63555411
2023-01-28,2847,60,45,138176848,31584654,12803048,64869229,63555456
2023-01-29,679,8,11,138176956,31584654,12803048,64869237,63555467
2023-01-30,7007,150,83,138177493,31584725,12803049,64869387,63555550
2023-01-31,11690,241,120,138178579,31584845,12803049,64869628,63555670
2023-02-01,11002,174,181,138179497,31584858,12803049,64869802,63555851
2023-02-02,12845,215,192,138180485,31584864,12803049,64870017,63556043
2023-02-03,8734,198,153,138181255,31584869,12803049,64870215,63556196
2023-02-04,1707,60,34,138181336,31584878,12803049,64870275,63556230
2023-02-05,622,6,4,138181378,31584878,12803049,64870281,63556234
